0000000000222222222222222222220000000000
0000000000222222222222222222220000000000
0000000000222222222222222222220000000000
0000000000222222222222222222220000000000
0000000000222222222222222222220000000000
0000000000222223333333333222220000000000
0000000000222223333333333222220000000000
0000000000222223333333333222220000000000
0000000000222223333333333222220000000000
0000000000222223333333333222220000000000
0000000000222223333333333222220000000000
0000000000222223333333333222220000000000
0000000000222223333333333222220000000000
0000000000222223333333333222220000000000
0000000000222223333333333222220000000000
0000000000000000000000000000000000000000
0000000000000000000000000000000000000000
0000000000000000000000000000000000000000
0000000000000000000000000000000000000000
0000000000000000000000000000000000000000
0000000000000000000000000000000000000000
0000000000000000000000000000000000000000
0000000000000000000000000000000000000000
0000000000000000000000000000000000000000
0000000000000000000000000000000000000000
0000000000000000000000000000000000000000
0000000000000000000000000000000000000000
0000000000000000000000000000000000000000
0000000000000000000000000000000000000000
0000000000000000000000000000000000000000
0000000000000000000000000000000000000000
0000000000000000000000000000000000000000
0000000000000000000000000000000000000000
0000000000000000000000000000000000000000
0000000000000000000000000000000000000000
0000000000000000000000000000000000000000
0000000000000000000000000000000000000000
0000000000000000000000000000000000000000
0000000000000000000000000000000000000000
0000000000000000000000000000000000000000